66.0	201.4	251.902	372.15
Acanthoscaphites	Adygeites	Abadehceras	Acanthoclymenia
Anagaudryceras	Alloclionites	Abichites	Aulatornoceras
Anaklinoceras	Amarassites	Adrianites	Beloceras
Anapachydiscus	Anatibetites	Agathiceras	Carinoceras
Astreptoceras	Anolcites	Alibashites	Chutoceras
Axonoceras	Arcestes	Altudoceras	Clauseniceras
Bostrychoceras	Argosirenites	Anderssonoceras	Crassotornoceras
Brahmaites	Brouwerites	Anfuceras	Delphiceras
Canadoceras	Catenohalorites	Arasella	Devonopronorites
Cirroceras	Cladiscites	Araxoceras	Domanikoceras
Coahuilites	Clionites	Avushoceras	Gogoceras
Damesites	Clionitites	Changhsingoceras	Hoeninghausia
Daradiceras	Clydonites	Chaotianoceras	Koenenites
Desmoceras	Cochloceras	Cibolites	Komioceras
Desmophyllites	Cycloceltites	Clivotirolites	Maternoceras
Desmoscaphites	Cyrtopleurites	Cyclolobus	Mesobeloceras
Didymoceras	Dionites	Daubichites	Mixomanticoceras
Diplomoceras	Discotropites	Difuntites	Naplesites
Discoscaphites	Distichites	Discotoceras	Nordiceras
Epigoniceras	Drepanites	Doulingoceras	Pharciceras
Eubaculites	Dronovites	Durvilleoceras	Playfordites
Eubostrychoceras	Eosteinmannites	Dushanoceras	Ponticeras
Eulophoceras	Eremites	Dzhulfites	Probeloceras
Eupachydiscus	Euisculites	Dzhulfoceras	Prochorites
Exicrioceras	Gabboceras	Eoaraxoceras	Retrotornoceras
Exiteloceras	Gnomohalorites	Eojiangxiceras	Sandbergeroceras
Forresteria	Gonionotites	Epadrianites	Schindewolfoceras
Fresvillia	Gymnotropites	Epitauroceras	Serramanticoceras
Gaudryceras	Halorites	Esfahanites	Sphaeromanticoceras
Gissarites	Hauerites	Etoushanoceras	Timanites
Glyptoxoceras	Helictites	Eumedlicottia	Timanoceras
Grossouvrites	Heraclites	Eusanyangites	Trimanticoceras
Gunnarites	Himavatites	Fengchengoceras	Uchtites
Hamites	Indojuvavites	Gastrioceras	Virginoceras
Hauericeras	Joannites	Geermuceras	Wellsites
Helicoceras	Juvavites	Hongshuiheites	NA
Herrickiceras	Lanpingoceras	Huananoceras	NA
Hoplitoplacenticeras	Leislingites	Hyattoceras	NA
Hoploscaphites	Lissonites	Iranites	NA
Hyphantoceras	Malayites	Jinjiangoceras	NA
Hypophylloceras	Megaphyllites	Julfotirolites	NA
Indoscaphites	Mesohimavatites	Julfotoceras	NA
Jacobites	Metasibirites	Kiangsiceras	NA
Jeletzkytes	Mojsvarites	Kingoceras	NA
Jimboiceras	Monophyllites	Konglingites	NA
Kitchinites	Nannosteinmannites	Kufengoceras	NA
Kossmaticeras	Nassichukites	Laibinoceras	NA
Lewyites	Neohimavatites	Lenticoceltites	NA
Libycoceras	Neotibetites	Leptogyroceras	NA
Lytoceras	Nevadites	Lijiangoceras	NA
Manambolites	Ophiorhabdoceras	Liuchengoceras	NA
Maorites	Paracladiscites	Longmenshanoceras	NA
Menabites	Paracochloceras	Lutites	NA
Menuites	Paradistichites	Medlicottia	NA
Metaplacenticeras	Paraguembelites	Meitianoceras	NA
Metoicoceras	Paragymnites	Metacrimites	NA
Morewites	Parajuvavites	Metagastrioceras	NA
Neancyloceras	Paratibetites	Mexicoceras	NA
Neocrioceras	Paratropites	Mingyuexiaceras	NA
Neodesmoceras	Peripleurites	Multisulcites	NA
Neogauthiericeras	Phyllytoceras	Neoaganides	NA
Neograhamites	Pinacoceras	Neocrimites	NA
Neophylloceras	Placites	Neogeoceras	NA
Nipponites	Proarcestes	Neoglassoceras	NA
Nostoceras	Protoplatytes	Nodosageceras	NA
Oiophyllites	Protrachyceras	Nomismoceras	NA
Oxybeloceras	Pseudosirenites	Pachydiscoceras	NA
Pachydesmoceras	Pseudothetidites	Pachyrotoceras	NA
Pachydiscus	Rhabdoceras	Paedopronorites	NA
Parapachydiscus	Rhaetites	Palaeolecanites	NA
Parapuzosia	Sagenites	Paraceltites	NA
Parasolenoceras	Spirogmoceras	Paralegoceras	NA
Patagiosites	Steinmannites	Paramexicoceras	NA
Phylloceras	Stenarcestes	Penglaites	NA
Phyllopachyceras	Styrites	Pentagonoceras	NA
Phylloptychoceras	Thetidites	Pericarinoceras	NA
Placenticeras	Thisbites	Pericyclus	NA
Polyptychoceras	Tibetites	Periptychoceras	NA
Ponteixites	Tozeria	Pernodoceras	NA
Pravitoceras	Tragorhacoceras	Phisonites	NA
Prionocycloceras	Tropihalorites	Planodiscoceras	NA
Pseudobaculites	Vandaites	Pleuronodoceras	NA
Pseudokossmaticeras	Wopfingites	Propinacoceras	NA
Pseudophilites	NA	Propopanoceras	NA
Pseudophyllites	NA	Prototoceras	NA
Pseudoxybeloceras	NA	Pseudostephanites	NA
Puzosia	NA	Pseudotoceras	NA
Rhaeboceras	NA	Qianjiangoceras	NA
Rugaptychus	NA	Qinglongites	NA
Ryugasella	NA	Retiogastrioceras	NA
Saghalinites	NA	Roadoceras	NA
Scalarites	NA	Rongjiangoceras	NA
Sciponoceras	NA	Rotodiscoceras	NA
Solenoceras	NA	Sabaliceras	NA
Sphenodiscus	NA	Sanyangites	NA
Spinaptychus	NA	Schizoloboceras	NA
Spiroxybeloceras	NA	Shangsilites	NA
Submortoniceras	NA	Shevyrevites	NA
Tetragonites	NA	Shouchangoceras	NA
Texanites	NA	Sinoceltites	NA
Trachybaculites	NA	Stacheoceras	NA
Trachyscaphites	NA	Stoyanowites	NA
Turrilites	NA	Strigogoniatites	NA
Vertebrites	NA	Subeothinites	NA
Yezoites	NA	Sundaites	NA
Zelandites	NA	Sutchanites	NA
NA	NA	Syrdenites	NA
NA	NA	Tapashanites	NA
NA	NA	Timorites	NA
NA	NA	Trigonogastrites	NA
NA	NA	Urartoceras	NA
NA	NA	Vedioceras	NA
NA	NA	Vescotoceras	NA
NA	NA	Waagenoceras	NA
NA	NA	Wangrenoceras	NA
NA	NA	Xiangulingites	NA
